Montana

Alberton: Siarra McDonald

Anaconda: Skylar Lofing**, Justin Stoppler, Kali Vine**

Arlee: Margaret Shinn**

Baker: Taylyn Dukart**

Ballantine: Logan Donally**, Madison Rohrer**

Belgrade: Dominic Bair, Jaden Blackburn**, Skye Chappell Lindsay*, Ashlyn Cleys, Olivia DeSimone*, Laura Evans, Andrea Falle, Madelynne Fast, Isabelle Getten, Braden Heidbrink, Jennifer Johnsen**, Tessa Kamanski, Lauren Kemp, Reyann Larkey, Haylee Lea, Joshua Lester**, Kandon Lewis, Heather Maddock, Hannah Madsen**, Sarah Maryannakis*, Dalton Mattson, Jayden McGowen**, Melissa Meredith, Maranda Meyer, Makell Meyle**, Miles Naberhaus*, Travis Newsom, Alexander Nordstrom**, Charis Omohundro**, Jeremiah Peterson, Joey Riebe**, Justin Riekenberg, Abigail Ross*, Corey Smith, Jessica Syvrud**, Alexis Thompson, Reegan Tigner, Sky Tillett**, Hannah Tolley, John Vincent*, Aubree Waldbillig, Savannah Willard**, Ariane Williams, Hannah Wolfe

Belt: Makayla Murphy

Bigfork: Isaac Burdick*, Noah Jakovac, Logan Taylor**

Big Sky: Julie Grimm Lisk, Madison Longwell

Big Timber: Jeanne Conner, Mark Garrard**, Jessie Holton, Christopher Norem, Brandon Schwers**, Lauryn Yuzeitis*

Billings: Keaton Anderson, Gregory Andriolo, Shayna Armer**, Paul Ashmore**, Kathleen Bales*, Kaley Bell**, Haley Berkram, Isaac Birdwell*, Spencer Bower, Erin Buhler**, Lindsay Cantwell, Mackenzie Carlson**, Alliya Champlin**, Jianna Clinton, Heather Connolly*, Kayla Daily**, Corinne Day, Mason Elkin*, John Elliott, Shania Fagan**, Gavin Fox, Jacob Fritzler*, Grace Garcia*, Jordan Gibbs, Madison Gilsdorf**, Chisum Green, Taylor Griffin*, Madison Haagenson, Emma Hagen*, Celestia Hammond**, Andrew Harmon*, Sydney Hawbaker**, Rachel Hawsey**, Jessica Heldt, Tyler Herbert, Debbie Hogue, Micah Holt-Seavy*, Bethany Jackson, Jameson Jessup*, Ross Keene, Mackenzie Ketchum**, Peyton Kimmel, Sara King*, Madelyn King**, Colton Klaudt, Madison Koterba, Kelsey Kraft**, Benjamin LaBeau**, Breanne Lewis, Mariah Linse**, Connor Maas, Alexander Machado**, Megan Malmstrom, Daniel McGee*, Paula Mcmahon, Blayne Meyer*, Nico Micheletti**, Camryn Mickelson, Kordell Miller, Matthew Miller**, Harley Misner, Alyssa Munson, Clarissa Murray, Megan Myers, Victoria Neary, Zachary Nell, Joseph Nichols, Kayla Northrop, Cheyenne ODonnell*, Payton Osen**, Margaret Peterson*, Melissa Petrich, Brooks Pope, Racey Reynolds*, Ty Roadifer*, Gracyn Ross*, Morgan Sanchez**, Dylan Sandbak**, Russell Schiller**, Laura Schulz*, Megan Schwarzkoph**, Connor Scoles*, Caden Senitte*, Lin Shi, Emma Shutt*, Cole Smith*, Samuel Streeter**, Rebecca Strobel**, Haydn Swarm**, John Thompson**, Gabriel Tranel*, Kalysta Tripp*, Melinda Truesdell, Fancy Vogel Belcourt, Eliana Wagner**, Ronnel Walton**, Kathryn Waples**, Hunter Young**

Box Elder: Dakota Terry

Bozeman: Nathan Aguirre, Mohammad Al-Amin Abdul Adamu, Martin Aldrich*, Zayd Al-Kaisy, Delane Allen, Wyatt Alt*, Jessica Amende, Avery Amende**, Hattey Andersen, Brianna Anderson**, Amanda Anderson**, Noah Anderson, Ian Anderson, Logan Anderson*, Taylor Andrews**, Susan Andrus, Colleen Angarone, Emily Angus, Sean Argenbright, Gallage Ariyaratne, Maxwell Armstrong*, Kyler Ash, Austin Ash**, Ashlyn Baird*, Jonathan Ballard, Abdullah Bamani, Teagan Barndt, Tanner Barney*, Ossie Barton**, Raphaelle Bassak**, Mark Bates, Sarah Bean**, Ashley Beck, Alexis Bell, Jubrile Belo-Osagie, Darby Bettenhausen, Magdalena Beyer, Nicholas Bidegaray, Andre Bidegaray**, Matteo Bjornsson, Erica Blair, Deborah Blanchard, Tyler Bledsoe, Emily Blust*, Kara Borcher**, Mariah Boston**, Nicole Boteilho, Ethan Bowen, Zane Bowey, David Braun*, Heidi Brelsford**, Jacob Brewer, Alexander Brisson*, Korry Broderick, Madison Brown**, Jackson Brown, Dianna Brown** Haylee Bruce, Meghan Bruner*, Jada Bryant*, Sarah Budeski**, Derek Burke, Taylor Burlage*, Anthony Burnett*, Ocean Burnham, Owen Burroughs**, Ryan Busch**, Justen Carlson**, Caleb Carr*, Elena Carter, Kordian Cebulla, Alper Celik, Thomas Challeen, Paige Chapman**, Sevana Chapman, Brooke Charbonneau, Hannah Chawngte, Muzhou Chen*, Craig Christoffersen**, Calvin Cicha, Benjamin Clark, Noah Cleary, Michael Close, Jenna Coats, Henry Cole, Sadie Collins*, Riley Collins**, Jay Colombo, Maxwell Conser**, Cooper Converse**, Bridget Cooney*, Kajia Coziahr**, Ryan Craig**, Brianna Crane, Klazina Crawford, Magdalin Cummins, James Cusick**, Riley Daily, Jennifer Dankoff, Josephine Davidson, Sara Dee, Connor Demorest, Alyssa Dennis, Samantha Dewitt, Lucas Diehl, Barbara Do Amaral, Christopher Donahue, Zachary Dorow, Keiffer Doyle*, Martina Du, Michael Dvorsak, Christopher Dyrland-Marquis*, Mykaela Edwards, Jessica Eggers, Sarah Ekberg**, Alexandra Emmons**, Kara Erickson, Akasha Evans, George Faegre, Adam Fahlquist*, Gavin Faulkner*, Liam Fenn, Olivia Firth, Lena Fitzsimmons, Matthew Flanagan, Cody Flinders

Sam Fogel, Claire Forsman, David Fox, Morgan Fraley*, Meghan Franck**, Isabelle Franklin**, Libby Fremont, Kody Froehle**, Adam Fuller, Xiomara Gaibor-Intriago, Beverly Garrison, Caitlynn Gaston*, Marcy Gaston, Ashlie Gilbert, Tyler Going, Austin Goodrich, Jordan Goodwin, Christopher Goolsby**, Aysha Gossett**, Matthew Gotta, Katie Graham, Sean Griswold Mihalko, Yelizaveta Grubich*, Pinar Gunyol, Jessica Hackett, Samantha Haight**, Samuel Hale*, Laina Hall**, Nicole Hall, Nichole Hamilton*, Dyllan Hankins**, Dale Hansen**, Nikolai Hanson, Alexander Harreld*, Laury Harris*, Pamela Harvey**, Coy Harwood, Luke Hatschbach**, Molly Haviland, Nathaniel Haygood, Paul Hegedus, Alexandra Hellenberg, Adam Hellman, Sydney Henderson, Elias Hendricks, Noah Hense, Erin Hess**, Stephen Heywood, Alyssa Hickman** Mary Hicko*, Shane Higgins, Jonathan Holcomb, Robert Holland, Katherine Holmes, Alaina Holtquist, Ronald Horaney*, Tabitha Horton**, James Hubbell**, Adam Hubley, Jack Hueser*, Amy Humphrey*, Tyler Hunt-Smith, Tanner Ibach, Ellie Jackson**, Dana Janes, Cody Jessup, Noah Johnson**, Carston Johnson, Kara Johnson, Nicholas Joscelyn, Sean Kaleva*, Dawson Kanehl*, Hazal Katerina Evans, Katie Kauer, Alyssa Kaufman, Mahlet Kebede, Wyatt Keegan, Karsen Kelly**, Colin Kennedy*, Sophia Kennedy Overfelt*, Margaret Kerr**, Lauren Kesner**, Conner Killeen**, Aubrey Kimmel, Janessa Kluth**, Kyle Kramer*, Quinn Krause**, Ryan Krauss, Pushya Krishna**, Robert Kwapisz**, Bernard Lacey**, Amber LaCross*, Mackenzie Laidlaw*, Shelby Lampi**, Kenneth Lang**, Christine Lange, Kristian LaPoint, Lilikoi Latimer, Keeghan Lauver, Kaia Lee**, Isabel Leos*, Matthew Lessmeier*, Darya Lester*, Emily Lewis, Bridger Lohman, Katelynn Lombard, Paul Lorenzo, Connor Lowe*, Alan Lu*, Louis Luckay, Nikolas Lundgren, Kylee Macks, Logan Maczewski, Matthew Mamich*, Nicholas Manship**, Brittany Marbut, Brandon Marceau**, John Marquez, Leila Marsh*, Jake Marston*, Madeline May**, Chelsea May**, Bonnie McCallum, Bradley McCoy, Michaela McDonald*, Grace McDonnell*, Nicholas McGough*, Carter McIver**, Anna McKee*, William McKinney**, Shannon Mclaughlin, Paige McManus**, Robert Meagher, Ryan Meier*, Erika Meuli**, Nikki Michaels**, Alessandra Miller**, Katherine Miller, Amy Miller**, Kiersten Miller*, Kaylee Millhollin, Twila Miner, Grace Moloney*, Seth Montgomery, Kylie Moore, Juliette Moore**, Steffanie Morales**, Kaitlyn Morgan, Madeline Morgner, Danielle Morrison, Julia Mortier, Alexandria Moxley, Bailey Mund*, Maria Munro-Schuster, Jacob Munson

Amber Nabity, Bryce Neal, Grace Nelson**, Faith Nelson, Jacob Neumeier*, Zoe Norden*, Byron Norman**, Rachel Norris, Christian Nygren, Emily O'Brien, Lucille O'Hagan**, Jacob Oard**, Tiffany Ocampo, Garrett OConnor, Colin Ogilvie**, Snowden Olliff**, Garrett Olrogg, Rita Park, Cille Patten*, Molly Patten*, Siri Pederson**, Lilliana Perham*, Eoghan Perkins, Faith Perrins, Derek Perry*, Emily Pesicka**, Victoria Peterson*, Trevor Phelps**, Angelina Philippova, Juan Pilicita, Agustin Pineda, Chandler Pippin**, Dominic Pisaneschi**, Olivia Poole*, Joseph Poole, Paulina Power**, Jaclynn Pruitt*, Leah Raming, Oscar Ramos, Zoe Ratzlaff**, Tyler Ready, Charles Rehbein**, Jacqueline Reier**, James Richard Ines, Cole Richards, Bethany Ringer, Jacob Ritter*, Lily Rivers, Kennedy Robbins, Chase Robecker, Emma Roberts, Mallory Roberts**, Nicholas Rohrbach, Kathleen Rolin*, Hannah Rosanova*, Tabor Roulson**, James Rubin, Travis Russell, Wajdi Ruwaysa, Ethan Saberhagen**, Alexandria Sacco, Cole Sain, Rebecca Savage*, Heather Schaffnit**, Gabriel Schulze, Jakob Seib*, Antonina Seppi*, Anabelle Seybert**, Jeremy Shanok, Jacob Shea**, Colleen Shields**, Daniel Short, Sagan Simmons*, Charlotte Smith, Griffin Smith, Michele Smith, Mikayla Snyder*, Timothy Sonnenberg**, Kameron Speegle*, Chance Sprague*, Daniel Stahle, Kaylee Starbird*, Samuel Steele**, Ashlynn Stephens, Sara Stromberg, Amy Strommen, Alex Sutherland, Thomas Sutton, Shae Swenson, Lindsey Tandy**, Zachary Tannen, Molly Taylor**, Geoffrey Thorstad, Jordan Thronson**, Malinda Tjelta, Alexander Tkaczuk, Decker Trahan, Erin Trohkimoinen**, Megan Udeck*, Wesley Ulrich*, Maile Vale**, Erica Venkatesulu, Michelle Vered, Jennifer Vermeer*, Hailey Vidmar**, Junior Vilcapoma, Nathan Vinger, Zak Vinter**, Liam Vodehnal, Brock Vosburgh**, Zoe Waddell**, Holly Walker, Taylor Walker*, Keegan Walker**, Walker Ward**, Jacoby Warner**, Sara Weaver*, Angela Weikert, Jesse Weis, Bryn Welker, Mark West**, Hannah Wheeler**, Bryndon Wilkerson**, Justin Williams, Alea Williams, Stephanie Wilson, James Wilson, Stephanie Wilson, Nicole Wing, Elsa Wintersteen**, Elsa Wintersteen**, Jaden Woeppel, Collin Wright**, Elizabeth Yarnal**, Austin Ybarra, Angela Yonke, Shahabeddin Zaregarizi, Nickolas Zeibig-Kichas, Dylan Zellers, Marcos Zelver**, Jordan Zignego, Jacob Zimmerer

Bridger: Katelin Aisenbrey*, Xander Kraft, Sylvia Scianna**

Brockway: Brooke Larson**

Browning: Raynell Cree Medicine**

Butte: Caitlin Carmody, Kayli Desena*, Colby Hammack, Logan Johnson**, Eric Keenan**, Noah Loomis, Kayla Montoya, Mario Simon, Heather Wilson**

Cameron: Cael Brockmeyer**

Cascade: Quincy Balius, Ryan Bogden

Charlo: Claire Hibbs-Cheff, Ashley Shenyer

Chester: Madison Wiegand**

Chinook: Katrina Schlagel, Sierra Swank**

Choteau: Brooke Richins*

Circle: Rhonda Voss

Clancy: Elijah Barbee, William Cumley, Christopher Danielson, Jacob Harkins, Thomas Jergeson**, Dylan Krezelak, Keaton Kurokawa, Hannah Larson, Conner Nash**, Dane Rieger**, Braden Scherting, Maggie Smiedala**

Clyde Park: Alan Fremont

Coffee Creek: Julia Grubb**

Columbia Falls: Stefano Abreo*, Genevieve Devitt, Hayden Falkner*, Brendan Gibson**, Faith McGehee**, Carla Nicosia, Emily Scallen**, Demi Sullivan, Aaron Torgerson

Columbus: Kellie Depuydt, Devin Livergood, Dalton Marjerison

Conrad: Allison Broesder**, Morgan Fowler*, Quinn Gianarelli, Clint Judisch*, Shaelyn Meyer, Mariah Moulton**, Kristina Rauscher*, Carley Ries**, Hayley Ries**, Augusta VanDyke*

Cooke City: Sarah Griffin

Corvallis: Tyler Chouinard*, Abigail Dunn*, Kayla Fields**, Alec Nys

Crow Agency: Farrahlean Springfield

Culbertson: Macy Kirkaldie**

Cut Bank: David Taylor**, Kimberly Woodring

Dillon: Kylie Christiansen*, Bradley Harvey, Tyler Sitz, Mikaela Trang

East Helena: Aimee Balcerzak, Britta Binde**, Alexandria Fasbender**, Bethany Lindner, Kaitlyn O'Malley*, Caitlyn Patera, Kelsey Soltis*, Amber Thurston**

Ekalaka: Glen Frye*, Cameron Wolenetz*

Emigrant: Kara Orser

Ennis: Kristen Cook, Payton Fortner*, Charles Gilmore**, Jessica Kudelski*

Eureka: Brittany Hall*

Fairfield: Reegan Carper*, Cantor Coverdell, Hailey Mills*

Fairview: Adam Elletson

Florence: Sarah Berg, Steven Betts, John Gross

Fort Benton: Gabriel Burdick, Mandy Wright, Mandy Wright

Fort Peck: Taylor Padden

Fort Shaw: Margaret Anderson, Allie Steinbach**

Frenchtown: Ryan Hardy*, Dustin Olsen

Froid: Karrington Kjos*

Gallatin Gateway: Syvanna Nagel, Seth Vinger, Alyssa Woodworth Beck**

Gardiner: Dani Hatfield**, Jacob Oppelt, Bryson Stermitz

Garneill: Brandon Bergum*

Geraldine: Makae Nack

Gildford: Devon Miller**

Glasgow: Madison Knodel**

Glen: Hailey Garrison*

Glendive: Saige Dorwart**, Michael Hopfauf*, Regina Roos, David Skerritt*, Averie Skillestad**

Great Falls: Andromeda Abarr**, Annabella Aline**, Andrew Aron*, Jake Artis*, Cody Barnes**, Rebecca Bergman**, Noah Brennan, Bodhin Brown*, Mary Brown**, Cayley Bushong, Caitlyn Cayer, Alyssa Cereck, Darian DAntuono**, Laura Detrick**, Colton Devoss, Delayne Doucette*, Jack Dresel, Kayci Edwards*, Jonathyn Elliott**, Daniel Enseleit*, Aidan Evans, Jacey Fillinger, Sydne Fletcher*, Jason Gleason, Coleman Good*, Jennie Gresham**, Erik Grosvold, Kayla Haffner*, Dylan Halverson, Quaid Harlan, Meghan Haynes*, Britt Henneford*, Charles Holcomb**, Taylor Houtz**, Emily Hovland*, Breanna Hudik, Kelsay Jensen, Anna Johnson*, Daniel Johnson*, Lisa Johnson, Jordan Johnson, Amberlie Kuglin**, Brandyn Lackey**, Michael Marler, Jack Milkovich, Haley Milton*, Veronica Muha*, Brianna Olson*, McKenna Osentowski**, Samantha Payne, Elias Pomeroy, Alexandra Potts, Rebecca Pulley*, Twila Reovan*, Samuel Roux, Tanner Rubino**, Kyle Rutten**, Leeanna Schearer**, Emma Simpson*, Benjamin Skinner*, Stasha Sokolowski**, Olesia Soldyshev*, Ericka Taylor*, Bowen Trystianson, Kyra Willis*, Kyle Winkler**, Stephen Wurz,

Greenough: Annika Erickson*

Hamilton: Rachel Ariaz**, Trenton Bushmaker, Dulcie Ferguson-Belanger, Cameron Fisher, Brooke Lawry**, Phillip Melnarik**, Charles Melnarik, John Winfield*

Hardin: Josephine Hammond*, Todd Lundberg*

Harlowton: Kaitlin Lane, Madison Wasson*

Harrison: Douglas Christensen, Austin Ransom*, Julie Todd

Havre: Valerie Guyant, Tracey Jette, Megan Lindbloom**, Trevor Mork*, Bryant O'leary, Danielle Stoll, Jessica Sutherland, Kasthuri Udayakumar

Helena: Alison Amy, Mary Anderson, Kira Axline, Olivia Bauman*, Zachary Begler*, Nicodemus Berbos, Megan Bonde*, Noah Brooks*, Cody Brown, Clarice Burger*, Arynn Collins**, Arynn Collins**, Cody Crowley**, Marisa Curtin*, Jennifer Didriksen*, Konnor Donaldson**, Hannah Dreesbach**, McCall Elverum, Aidan FitzGerald*, Cassandra Fortenberry, Kendall French, Justin Fruh*, Natalie Gates**, Madison Gates, Kipton Giddings*, Emily Griffiths**, Cole Hasquet*, Michelle Herron, Benjamin Hunthausen**, Jenna Lauf**, Kalli Lawrence*, Taelyr Lieberg**, Kaci Lloyd**, Grace Ludlow**, Allison Maricich, Jessica Maynard**, Sean McCormick, Garret McLean, Jacob Michaletz**, Mikal Mihelish*, Keely Morrison**, Mark Mousel**, Alyssa Newhart**, Jared Newman, Casey Pallister, Ashleigh Poppler, Elliott Pryor**, Kaitlyn Rangitsch, Airica Rishavy, Lauren Roach**, Meghan Robinson**, Gunter Roylance**, Celina Sanchez**, Sydnee Sather*, Thomas Schmidt*, Megan Skolrud, Christopher Smith, Hadley Snortland, David Standberg*, Jacob Streets-Ballinger, Ayanna Syvrud**, Jesse Thomas, Madison Todd**, Ryan Twardos, Brooklyn Vincent**, Lindsay Walter, Zachary White**, Witt Williams**, Brooke Wilson, Alexa Wrigg**

Hilger: Jada Goettlich*

Hinsdale: Mickayla Johnson**

Hobson: Jace Aune*, Morgan Wertheimer**

Hot Springs: Berton Detienne

Huntley: Olivia Bechtold*, Baylee Jones*

Huson: Joel Bridgeman**, Hayden Thommen*

Hysham: Shaunessy Bidwell

Joliet: Dawson Bancroft**, McKendra ODore*

Kalispell: Joshua Anderson**, BoDayle Battleson, Jared Brenden, Tyler Brockman*, Matthew Carroll**, Caleb Cohen, Isabelle Cuthbertson*, Lillian Diegel*, Adam Elerick, Aidan Fritz*, Jakob Hembroff, John Hinchey**, Aaron Hunt, Robert Hurly**, Clayton Jaques*, Mckenna Johnson, Collin Kazmier**, Tyler Kitch**, Steven Mattson, Lindsay McDonald*, Marjorie McMahon*, Christine Miller, Kelly Mower, Kyle Mulcahy*, Nathan Patera*, Julie Patrick*, Erik Pino, Grace Pirrie*, Brianna Rendina*, Sienna Riley, Chase Skelton, Donald Skramovsky, Jonathan Sorensen**, Jamie Steers**, Dawn Tacke**, Isabelle Thomas**, Meghan Upham, Daniel Vinogradov, Bethany Walker**, Kyle Webster, Cadie Williams**, Gregory Wilson

Kila: Christian Stratton

Kinsey: Kolleen Gustad

Lakeside: Isaiah Dunham, Griffin Fischer*, Ahna Kreitinger, Aubree Pauls**

Lame Deer: Terrance Limpy*

Laurel: Callie Allen, Danae Filpula Ankney**, Rachel Meiers, Zachary Negrette**, Daniel Novasio, Daniel Novasio, Marcus Twichel, Mikayla Zakrzewski*, Mikayla Zakrzewski*

Lewistown: Cole Ayers, Becca Bawden**, Annie Franz**, Jessica Granger**, Megan Honeycutt, Zachary Jensen, Tanner Mannin**, Ivy Southworth*, Alysah Southworth**, Emily Standley, Tucker Walter

Libby: Niklaus Gier*, Niklaus Neumann*

Livingston: Lindsay Aun, Jamie Cahoon, Kristina Catalano, Colton Gavne, Lindsay Lee*, Mary Levandowski, Aaron Lewis*, Sheridan Oakes, Andoni Oakes, Zoe Randall, Isaac Rowland, Richard Sadleir, Clyde Schulein**, James Scott, Heather Shaffer, Tavin Stewart, Joseph Swindlehurst, Annie Waldum, Michaela Williamson, Levi Wolfe, Dominic Zumpano

Lolo: Angela Fowlkes, Madison Liechty, Madison Lightfield*

Malta: Zachary Drabbs*

Manhattan: Emma Borrmann*, Cayl Deboer, Parker Dyksterhouse*, Krista Ebbighausen**, Ashley House, Alexander Johnston*, Chelsea Jones, Alayna McGuiness, Emry Olsztyn

Marion: Carley Anderson*, Brady Peiffer*Medicine Lake: Abigail Ator*

Miles City: Gabe Gundlach*, Kyle Haughian, Jonathon Kilen, Claire Kloster*, Elizabeth Ozawa-Hampton, Kate Rehm*

Missoula: Kyla Andres**, Sydney Auld*, Amber Benson*, Eliana Boylan**, Taylor Brinkman*, Shaun Brodie*, Mikayla Bronec, Molly Burghardt*, Axel Carlson, Sydney Chase**, Sydney Craig**, Brooklyn Crape, Joshua Crumpton, Cody Curtis*, Anne Dellwo*, Alyson Druyvestein, Logan Gilder, Hayley Glassic, Kayla Gordon, Marina Gray*, Theodore Grosgebauer**, Renee Hodgdon**, Mikyong Hong, Huei-Ling Tsao, Jordan Huffman*, Riley Jarvis*, Matthew Keenan, Thea Keene**, Jada Knight**, Daniel Koehler*, Andrew Koehler, Daniel Koehler*, Lindy Kolb, Emma Krebsbach*, Filip Langner**, Jessica Longstreth**, Samuel Lubov**, Abigail Meeds*, Liam Mercado, Caden Messer**, Lance Nichols*, Riley Nielsen**, Cora Phoenix-Price, Kailyn Quinn**, Steven Rehbein, Eryn Robinson, Byron Rollins**, Kenneth Roth, Shannon Scally, Tomas Scariano*, Rachel Schubert*, Addison Scott*, Caroline Stahl**, Saralyn Standley*, Scout Sutton, Kevin Thomas, Ethan Turner, Timothy Uhlenbruck**, Dee Vang, Emily Weber**, Stephanie Wozniak**

Molt: Jacob Agar

Moore: Kaitlyn Weinheimer

Nashua: Sophia Koessl**

Norris: Erin Brush**

Park City: Brittany Frank**, Maddison Munger

Pinesdale: Connie Watt**

Plains: Veronica Black*

Plentywood: Ronni Anderson, Jasmine Harper**, Nate Harris**, Randy Heppner

Polson: Weston Danley**, Alexander Mausshardt*, Matthew McGuyer, Ivan Nethercott

Pompeys Pillar: Colton Weeding*

Pony: Allison Larock

Poplar: Megan Gourneau

Pray: Grayson Smith

Red Lodge: Frances Graham*, Anna Prinkki, Alex Thuesen*

Reed Point: Madilyn Emter**

Richey: Hayley Conn, Ellie Smith**, Isaac Sponheim**

Roberts: Jess Mysse

Rollins: Ian Tanninen

Ronan: Jenaya Burns*, Jenaya Burns*, Jarrett Richey*

Roundup: Cash Cota**, Anamarie Goffena, Faith Nichols*

Rudyard: Katelyn Hansen*

Saco: Bailey Funk*

St. Xavier: Lila Bull Chief

Shelby: Jarod Anderson*

Shepherd: Alexander Bedford, Taylor Crockford*, Ashton Jorgenson, Kohltrane Michels, Derrick Reimann*, Arielle Tommerup*

Sidney: Carlee Strasheim**

Stevensville: Erik Biesterfeldt, Benjamin Hale, Gabrielle Lykins*, Zachery Robison, Kayla Schmiedeke**, Sydney Torrey*

St. Ignatius: Alexa Greene**

Stockett: Kenadee Chartier

Sun River: Haelee Essebaggers*, Serenity Wolfe*

Terry: Amber Brubaker

Thompson Falls: Bridget Thor*

Three Forks: Martha Buenrostro*, Matthew Krueger**, Ian Phillips, Morgan Sorensen*, Kyle Stone**, Brenna Szott, Kayla White**

Toston: Elizabeth Conley

Townsend: Bailee Field*, Easton Hatfield: Amanda Ruckey*

Twin Bridges: Kollin Anderson*

Ulm: Sydney Dickinson*, Tahsha Wehr

Valier: Zachary Stoltz*, Tanner VandenBos

Vaughn: Riley Annis

Victor: Mary Allred*, Eva Hathcox*, Henry Smith

Vida: Evan Eggebrecht

West Glacier: Maureen Hoff

West Yellowstone: Hayley Hain*

Whitefish: Sydney Archibald*, Audrey Brady**, Denver Dicks, Katharyn Dolan, Gail Fassnacht**, Abigail Long, Clare Menzel, Stephanie Shepherd**, Ella Van Vlack*, Madison Wilken**

Whitehall: Shihua Brazill, Jacob Flynn, Madison Lombardi*, Conor McNamara, Gabriel Ordahl

White Sulphur Springs: Joshua Phillips**

Wilsall: Seth George

Winifred: Brietta Boyce*, Mauri Elness, Simon Fordyce

Winston: Carly Sell

Wolf Creek: Cody Barnes**

Wolf Point: Thomas Brown**, Kaitlyn Brown**, Chrystal DeCoteau, Shelby Hafner**

Out of state

Alabama

Athens: Sarah Fry**

Fairhope: Turner Carrick

Huntsville: Riggs Ferguson**

Pleasant Grove: Theresa Davidson

Vestavia: Jack Rosenthal

 

Alaska

Anchorage: Ryan Bickford, Rebecca Forsyth, Isabella Goodman*, Laura Hanshaw**, Rena Michaud, Joaquin Monterrosa**, Joaquin Monterrosa**, Zachary Nelson**, Ryan Perius, Ari Romberg**, Savanna Rucker*, Derrick Stewart, Faina Toole**

Chugiak: Carson Head*, Grace Nichols**

Dutch Harbor: Joseph Henning**

Eagle River: Heidi Freeborn, Darby Mullen*, Taylor Rukes*

Fairbanks: Tigan Donaldson**

Glennallen: William Matthews

Homer: Mia Alexson**, Timothy Blakely**, Douglas Dean**, Denver Waclawski**

Juneau: Jessica Gregg*, Alexandria Hayward**, Mikayla May**, Brysen Mitchell**, Kathy Tran, Geoffrey Wyatt

Kenai: Elizabeth Tobias*

Palmer: Annika Lundstrom*, Rory McLean**, Anna Parreira**, Devon Wear, Devon Wear

Sand Point: Madison Thompson*

Soldotna: Austen Eriksson**

Thorne Bay: Amy Jenson

Wasilla: Isaak Bell*, Elijah Cook, Emily Hess**, Sarah Montalbano**, Carissa Vasquez*

Willow: Anne Warner

 

Arizona

Gold Canyon: Katherine Kalebich**

Mesa: William Rosler

Phoenix: Jordin Tyson

Prescott: Clinton Culbert

Prescott Valley: Audrey Lockling**

Scottsdale: Rachel Balko*, Michael Roduin

Surprise: Logan King*

Tucson: Mariah Romero

Springdale: Korey Garibaldi

 

California

Los Altos: Jordan Higgins*

Ahwahnee: Ethan McCully

Alameda: Suzanne Eggert

Alamo: Nicholas Obsitnik

Aliso Viejo: Cooper Bien

Apple Valley: Jacinda Cisneros, Jacob See

Aptos: Moorea Nowark

Arnold: Sierra Stephens*

Atscadero: Scott Beraud

Auburn: Kristy Kenworthy

Ben Lomond: Carly Hill*

Brentwood: Kassidy Lywandowsky**

Camino: Jack Little**

Carlsbad: Colby Lara**

Clayton: Michael Baker

Concord: Jake Owens**

Costa Mesa: Ciera DAlessandro**

Danville: Alexander Brown, Gregory Lowe, Melissa Widas**

Edwards Air Force Base: Isaac Bennett*

El Cajon: Justin Scarbrough**

El Dorado Hills: Nathan Stellmacher**

Elk Grove: Kenzie Ferguson, Brayden Kingston*

Encinitas: Cade Peterson

Fairfax: Jad Wright

Fallbrook: Kyle Murray

Fresno: Delaney Kearns

Fullerton: Brock McClure

Gilroy: Katherine Boynton

Imperial Beach: Sarah Maynard*

Irvine: Michael Cox

Ladera Ranch: Megan Good*

Lafayette: Greyson Downes*, Sarah McClain**

Lakeport: Brent Hinchcliff**

Lathrop: Andrew Lorentz

Lemon Cove: Lacey Clark

Lincoln: Kolson Mendelsohn*

Livermore: Olivia Buskard*, Charles Siders**, Joseph Stangl*

Los Angeles: Joshua Dinner

Los Banos: Isabella Patterson*

Mammoth Lakes: Raychel Limnios**

Martinez: Sydney Cave*

Mill Valley: Lily Toussaint**

Modesto: Drew Bakker*, Aidan Sulak

Moorpark: Emma Lauchner**

Moraga: Ryter Ullrich, Jake Walgenbach*

Murrieta: Morgan Brennan, Abigail Murray**, Emilia Poradowski

Newbury Park: Taylor Freedman

Novato: Chet Robertson

Oakland: Erik Sundsmo

Oceanside: Edward Escamilla*

Olympic Valley: Jeremy Pascal

Palo Cedro: Sierra Butler

Pasadena: Lawson Pitre

Piedmont: Jacob Mura

Placerville: Lars Bolster**, Cole Williams

Pleasanton: Craig Holtzclaw

Portola Valley: Neal Coberly

Rancho Cucamonga: Cesar Ulloa

Redding: Josephine Doolittle*

Redondo Beach: Lauren Pierson**

Ripon: James Cwick

Rocklin: Quinten Salie*

Sacramento: Johnathon Hobgood, Nicole Hopkins**

San Diego: Kathleen Haupt*, Kimberly Scanlon, Amanda Spidell, Pheona Wood*

San Jose: Mark Dorcak**, Karsten Kleiner, Brian O'Neil, Shelby Phillips, Ashlyn Varga**

San Leandro: Benjamin Bega

San Pedro: Keli Mezin*

San Rafael: Lara Weisenburg**

San Ramon: Patrick Paraiso

Santa Cruz: Marshall Carter**

Santa Rosa: Samuel Allen*, Joseph Bone*, Hannah Williams**

Sonoma: Sarah Kiser*

South Lake Tahoe: Nathan Griffith*

Suisun City: Derek Clawson

Sunnyvale: Katie Fasbender

Tehachapi: Cody Harrington**

Temecula: Chad Kanow

Thousand Oaks: Jacqueline Bird**

Trabuco Canyon: Nina Johansson**, Mary Norris**

Truckee: Hailey Sinoff**

Tulelake: William Schumacher*

Turlock: Clayton Abrams*

Visalia: Evin Haworth**

Walnut Creek: Katharina Bent, Philip Gehde*

 

Colorado

Arvada: Lindsey Andrews, Madison Berres, Victor Boyer, Dax Grossman*, Mason Lane, Connor Maines, Torrey Mcloughlin, Stephen Thompson**

Aurora: Zachary Kauffman**, Stephanie Xavier, Camden Young-Scovill**

Avon: Jacob Vickerman*

Bailey: Josefine Martin**

Boulder: Annabel Agras, Sean Barton*, Isaiah Cormier**, Cameron Dudiak, Carter Moffitt**, Jonas Mulder-Rosi, John Pemberton, Samuel Rosenbaum**, Grace Wynne**, Claire Zuetell**

Breckenridge: Benjamin Carlson

Broomfield: Jacob Claeys, Kolton Gochis

Carbondale: Colin Hipona*, Ivey Trulove

Castle Pines: Max Demarco, Amanda Wilkins*

Castle Rock: Abigail Conley*, Grace Lloyd, Spencer Maclean*, Bryan Rasbid*, Josephine Rodrigue**

Centennial: Abigail Hustis**, Delaney Smith**

Colorado Springs: Klara Aspelin*, Caleb Battersby*, Daniel Borchert**, Kelly Farnham*, Dalton Giesbrecht, Patrick Gould**, Kanoe Lyons**, Matthew Magoon**, John McConnell, Rachel Pearson

Conifer: Gunnar Vega

Denver: Joseph Barber*, Benjamin Johnston*, Cooper McCleery*, Kaitlin Mullowney**, Jack Murphy, Charles Parrott*, Ruth Trueman

Durango: Jenna Beckley*, Arthur Chase, James Pope

Edwards: Zoe Livran*

Englewood: Colton Vick*

Erie: Kate Berg**, Fischer Moore*

Estes Park: Piper Lasota*

Evergreen: Rachel Elander**, Rachel Elander**, Nicole Ellis**, Sean Hennessy**, Shannon Muenchow, Jack Pearson**, Matthew Ronder*, Skyler Yanish

Fairplay: Jayme Dyc**

Fort Collins: Elizabeth Bruenger**, Katherine Carlson*, Blake Dragan**, Michael Goldstrom**, Jacey Lyon**, Natalie Mahoney**, Samantha Myxter**, Howard Seim**

Fountain: Christen Barringer*

Fraser: Theodore Loo*

Golden: Paul Armitage*, Logan Bristol, Turner Gordon*, Roxanne Holmes**, Austin Hull, Megan Oaklief, Rebecca Reeder**, Kylie Sumpter**

Greeley: Ashley Pastelak

Greenwood Village: Matthew Simpson**

Gunnison: Kali Wiggin*

Highlands Ranch: Griffin Barnard**, Grant Fink*, Hannah Provan*, Lyra Reynolds**

Hudson: Eric Martin**, Randall Martin**

Lafayette: Emma Vernon**

Lakewood: Spencer Krupa, Susanna Walsh**

Littleton: Tanner Lyle**, Robert Manta**, Jillian Overmyer**, Sydney Pearman, Samantha Riebling*, Katelyn Treese*

Lone Tree: Michael Prazak

Louisville: Quinn Noonan

Loveland: Landon Lees*

Montrose: Bennet Bayliss*

Niwot: Natalia Eigner**

Parker: Montgomery Bruns, Kaylin Clark**, Derek Rodell, Abigail Zimmerman**

Peyton: Skylee Laser*, Spencer Scamman*

Sedalia: Lauren Jackson**

Steamboat Springs: John Coon*, Taylor Olson*, Tyler Strnad

Telluride: Chandler Bennett

Vail: Finn Andersson**, Matthew Glendining*

Westminster: Georgie Gochis*

Windsor: Kylie Baker, Kirk Dowdy, Jordyn Seibert*

 

Connecticut

Canton: Maxwell Allmendinger

Fairfield: Michael Coppola*

New Canaan: Katherine Somerby**

Sandy Hook: Jon Grimes

Sharon: Autumn Freudenberg*

 

Delaware

Greenville: Caroline Crouse**

 

District of Columbia

Washington: December Touhey*

 

Florida

Riverview: Nicolas Pichette

St. Augustine: Lauren Stanford**

Tallahassee: Lillian Ellegood

Trinity: Magdalena Kosciolek*

 

Georgia

Canton: Matthew Haller

Ellijay: Ryan FitzSimmons*

Evans: Reilly Teigen*

Gainesville: Dustin Parker*

Rockmart: Aaron Morrenzin

Smyrna: Sarah Nordahl

Waleska: Jeremiah Bass

 

Hawaii

Honolulu: Evan Turner

Kihei: Anne-Marie Greig*

Wailuku: Cassidy Kiyabu**

 

Idaho

Blackfoot: Jessie Bacon

Boise: Jacob Connelly**, Mckenna Drevno, Katelyn Duncan, Tyler Flowers*, Cyril Halvorson*, Connor Hayden, Kayla Kozisek**, Tessa Park**, Andrew Peterson*, Henry Poole, Olivia Ross**, Hailey Sautebin

Coeur d'Alene: Madeline DeMarco**, Aiden McCahill, Aidan Young

Eagle: Nathaniel Burman, Paige Roehling*, Tate Tominaga, Joshua Troy*

Felt: Elise Reynaud**

Hailey: Alexander Gilman*, Alexander Gilman, Kegan Lupton, Royce Rheinschild**

Hayden: Michael Dooley*

Heyburn: Costa Delis, Luca Delis

Idaho City: Victoria Billings

Idaho Falls: Iris Bowler-Spohnholz, William Mangan**

Ketchum: Sean OConnor*

Lewiston: Madeline Metcalf*

McCall: Ariana Woods**

Meridian: Kendall Fedore**, Mae Kjaer**, Zach Redd

Moscow: Tanner Lawson

Nampa: Brittany Dunaway

Nezperce: Kathryn Riggers**

Parma: Riley Morgan

Pocatello: Sage McNulty

Post Falls: Brynn Roberson*

Rathdrum: Gabriella Schaffer**

Rigby: Joseph Winjum

Rupert: Cassandra Beene**

Sandpoint: Max Edmundson*, Katherine Kaul**, Lauren Seuell*

Sugar City: Tyler Trogden

Weiser: Emma Davidson**

 

Illinois

Belvidere: Jennifer Becker

Carol Stream: Jake Ullman**

Champaign: Sofia Rodriguez Todd**

Countryside: Thomas Effeny

Elgin: Alexis Gora

Elmwood Park: Abby Stevenson*

Grayslake: Lauren Morris**

Libertyville: Samuel Stortz*

Naperville: Casey Sage

North Barrington: Frances Browne

Oswego: Grace Beck*

Plainfield: Hannah Jackson**

St. Charles: Katherine Gardner*

Scott Air Force Base: Ethan Abrahamson

Springfield: William Moran

Western Springs: Michael Piccolo*

Yorkville: Alexandria Betzwiser

 

Indiana

Crown Point: James Torreano

North Vernon: Brittany Locke

Schererville: Samantha Dittrich*

South Bend: Guadalupe Ashley, Thomas Pomarico

 

Iowa

Ankeny: Jaedyn Birchmier*

Bettendorf: Tyler Palmer

Dubuque: Amy Henson*

West Des Moines: Benjamin Nelson

 

Kansas

Alma: Devin McClayland

Belvue: Mary Greene

Colby: Conner Mccollum

Lansing: Winston Downing**

 

Kentucky

Cold Spring: Brigid Johnston*

 

Maine

Brunswick: Cameron Niven

Cape Elizabeth: Samuel Dresser**

Scarborough: Marielle Smith*

 

Maryland

Baltimore: Ugochukwu Onuoha

Manchester: Elyse Bruzdzinski*

Odenton: Robin Belton

Parkville: Sara Bancale*

St. Leonard: Theodore Danielson*

 

Massachusetts

Boston: Sage Stevens*, Sage Stevens*

Concord: Alonso Darias**

Easthampton: Carlie Raucher*

Falmouth: Maeve Burke

Lexington: Cole Oshiro-Leavitt**

Oakham: Thomas Goodhue**

Plymouth: Nicholas George*

 

Michigan

Ann Arbor: Hannah Wing

Brighton: Jade Berghoff*

Grand Rapids: Malcolm Cusack*

Jenison: Kyle Crater**

Madison Heights: Elizabeth Blauwiekel

Rockford: Collin Dalrymple*

St. Joseph: Paige Thomas*

Waterford: Anthony Clark

West Olive: Elliott Niemur

 

Minnesota

Apple Valley: Jared Fisher*

Bloomington: Henry Adams*

Breezy Point: Samuel Pfeiffer*

Cambridge: Bennett Christenson**

Champlin: Gabrielle Mocchi*

Cold Spring: Nicole Young

Eagan: John Jubenville*

Eden Prairie: Ajah Crowther**, Parker Milbrath

Farmington: Heather Schroeder

Hinckley: Alyssa Coop-Vickstrom

Hopkins: Raymond Brendalen**

Howard Lake: Thomas Horn*

Lake City: Garry Schaal**

Lakeville: Christiana Ruh**

Litchfield: Svea Ellingson*

Mankato: Dana Bohks*

Maplewood: Franklin Alongi**

Minneapolis: Lauren McMillan**, Toby Milow, Nina Perleberg*

Northfield: Allison Baggot**

Plymouth: Stiven Salgan

Rochester: John Eberhard, Alyson Welch**

Roseville: Lauren Galush

St. Cloud: Sarah Hopfner

St. Paul: Adam Coltvet*, Elizabeth Jones**

Sartell: Lexy Oftedahl*

Shorewood: Nathan Melnychuk

South St. Paul: Catherine Bauer*

Staples: Hetta Williams

St. Louis Park: Sean McSherry*

Victoria: Madeline Pernat**

Waconia: Charles Kinneberg

White Bear Lake: Karli Cich, Anne Schwartz*

Woodbury: Zachary Anders

Zimmerman: Noah Adams*

 

Missouri

Belton: Sarah Klein**

Columbia: Elizabeth Seal, Aubrey Wilson*

Florissant: Faith Quinlisk

Mount Vernon: Grant Bushman

Weston: Kaleb Baber

 

Nebraska

Gordon: Tyrell McClain

 

Nevada

Las Vegas: Andrew Hahn

Reno: Treyson Fiore*, Christian Hess**

Verdi: James Lebel*

Wells: Samantha Shamblin**

 

New Hampshire

Goffstown: John Comeau

Littleton: Benjamin Sweeney**

Milford: Matthew Chase*

Nashua: Elisabeth Cataluna*

 

New Jersey

Basking Ridge: Benjamin Tumolo

High Bridge: Nicholas Markarian

 

New Mexico

Albuquerque: Ian Sickafoose*

Los Alamos: Charlotte Berg, Malakai Coblentz**, Mark Garber*, Mary Grothaus**, Mary Grothaus**

Ranchos de Taos: Thomas Maggiore

 

New York

Amherst: Bryce Runckel

Buffalo: Kimia Stoffer*

Corning: Eric Powers

East Marion: Reese Costello**

Fabius: Matthew Goodman

Lewiston: Grace Fiacco

Pittsford: Kathleen Doyle

 

North Carolina

Apex: Dakota Peart

Denver: Abigail Lecompte

Franklin: Rita Hubbs

Garner: Madeline Kirch

Wilmington: Evelyn McEachern**, Randolph Miller*

 

North Dakota

Bismarck: Christianne Fisher

Cartwright: Amber Berry

Grand Forks: Erin Peck**

Killdeer: Candace Fredericks

Minot: Jonathan Mathistad**, Patrick Richardson**

Roseglen: Kimberly Whitebull

 

Ohio

Akron: Connor Watkins*

Atwater: Dana Booher**

Avon Lake: Mariah Goodman**

Bexley: Margaret Sutton

 

Oklahoma

Ardmore: Sydney Knox

Edmond: Jordan Wolf

Norman: Kevin Casula

 

Oregon

Beaverton: Sammy Al-Khatatbeh, Adrianna Geier

Corvallis: Drew Ellingson*, Jonathan Haberman**, Benjamin Nelson**, Meilo Seiter**

Dallas: Cassidy Devries

Eugene: Eva Happy**, Aaron Schoening*

Forest Grove: Lucio Stagnitti**

Hillsboro: Drew Messmer**, Hannah Simpson**

Hood River: Abigail Bergemann**, Erin Sutherland*

Lake Oswego: Ethan Looney*, Kenneth Meyer*, Aiden Prentice*, Brittain Schneider*

McMinnville: Melissa Flyckt

Molalla: Caden Fong**, Kaylee Fong**

Pendleton: Kristen Gregg**

Portland: Cole Chesley**, Trey Corrigan*, Sean Dang*, Matthew Hickey**, John Jensen, Cailey Lennehan*, Gabriel Litchfield, Natalie Perkins**, Sarah Rice*, Emily Robinson, Kyra Stoiantschewsky**, Demetri Stoumbos

Roseburg: Clare Dittemore

Rufus: Max Martin**

Salem: Elyse Beranbaum**

Sherwood: Jack Corno, Kendal Johnson, Takumi Kammerzell**, Nolan Todd

Silverton: Julia Kuenzi*

Sublimity: Zane Long*

Vale: Kyla Wright

West Linn: Erin Bjorklund**, Jorgen Stauffer**

 

Pennsylvania

Camp Hill: Casey Booth*

Dallastown: Clay Ness

East Berlin: Chase David

Lancaster: Jacob Skundrich**

Malvern: Jason Pichette**

McKees Rocks: Tracy Jones

Mount Joy: Aaron Boyers

 

Rhode Island

Cranston: Christopher McKay

 

South Carolina

Irmo: Meghan Moosbrugger

Lexington: Stone Sherman

Mount Pleasant: Paige Lund

Spartanburg: Hammond Scott*

 

South Dakota

Aberdeen: Monte Meyerink

Rapid City: Nicholas Benson**, Elizabeth Fullerton, Madison Gary, Madysen Gromer**, Carter Meyer*, Josie Omeara**, Madilynn Quinn**, Nathan Wiley*

Sioux Falls: Madison Lather

Twin Brooks: Sophia Seffrood**

Watertown: Yuqing Shao**

 

Tennessee

Normandy: Gordon-Robert Carlisle**

 

Texas

Austin: Samuel Alm**, Alex Aronoff**, John Carson, Akash Lucht

Boerne: Zachary Hauger

Carrollton: Jordan Harler

Dripping Springs: Emmalee Calvert

Fort Worth: Robert Felton

Houston: Jessica Brito**

Lewisville: Ryan Le Prell*

McKinney: Ashley Moore**

Montgomery: Sarah Johnson*

San Antonio: Katerina Lozano

 

Utah

Herriman: Kassidi Ashauer**

Millcreek: Austin Yapias

Ogden: Preston Lloyd*

Park City: Tucker Hoefler*, Konstantine Tsandes*, William Valentine

Roy: Bryan Suchey

Salt Lake City: Angelica Marcus, Jayson Stumph-Stoddard

South Jordan: Ryan Witt*

 

Vermont

Essex Junction: Therese Lupariello

Manchester Center: Serena Dublois*

Monkton: Gabriel Calvi

Rutland: Kristen Switzer

Shelburne: Janet Gamble**

Stowe: Paul Velk**

Underhill: Nathan King*

 

Virginia

Fredericksburg: Shannen Courtney, Riley Hess*, Jackson Schwab*

Leesburg: Brian Pettygrove

Midlothian: James Baker

Radford: Margaret Konkel

Warrenton: Andrew Colegrove**

 

Washington

Arlington: Zachary Hartman**

Auburn: Elliott Scheumann*, Auburn, Helena Wilson

Bainbridge Island: Connor Burke**, Maria Gallivan**, Maria Gallivan**, Lydia Goss*

Bellevue: Zachary Douglass*, Isaiah Ifanse

Bellingham: Zachary Archambault**, Eamon Carmichael*, Cyrus Frost*, Jack Humphreys**, Hayden Linderman**, Madison Simons*

Bonney Lake: Fredrick Fox

Bothell: Hunter Tripple*

Bow: Carson Hayes

Bremerton: Rachel Acchote

Carnation: Tessa Graham*, Kelly Hall*

Chehalis: Joseph Massingham

Cheney: Brock Winegar

Clarkston: Madeline Bunce*

Cle Elum: Patrick Broderick*, Eric Merkel**

Colbert: Tyler Kaminski, Payton Lungo**

Colville: Elise Loggers, Karisa Mitchell

Coupeville: Jacob Smith

Covington: Gabrielle Rizzo*

Des Moines: Veronica Soran**

Duvall: Zachary Schutte

Edgewood: Preston Holmgren

Edmonds: Adison McGaughey**, Colin Scheil*, Sawyer Wachter

Entiat: Shae Milne**

Enumclaw: Knoll Williams, Jessica Young

Everett: Caleb Hayes**, Isabelle Ivankovich*

Fall City: Blake Bostwick

Federal Way: Paul Czaplewski*

Gig Harbor: Mackenzie Knight, Madison McFarland**

Greenacres: Jerry Baker, Benjamin Kiehn**, Alexander Thorson

Hobart: Steven Latimer

Issaquah: Ava Bishop*, Samantha Kelderman**, Andrea Nelson**

Kelso: Mika Murphy**

Kennewick: Ashley Brinkley*, Bradley Winkel

Kent: Sultan Herrnandez*, Jacob Horstmann**

Lacrosse: Caleb Berquist*

Lake Forest Park: Robert Shoemaker

Lake Stevens: Camryn Dubois**, Dylan Schneider*

Leavenworth: David Hasse*, Kieran Ringel**

Longview: Cody Flynn*

Lynnwood: Hannah Hicks*, Madeline Keown**

Mead: Jack Hesskamp**

Milton: Zoey Atwood*, Marcus Hamel

Monroe: Bethany Garver, Jillian Reddick*

Mt. Vernon: Alexander Kaufman

North Bend: Carson Bolt

Northport: Natalee Glanville*

Oak Harbor: Jason Fly*

Olympia: Hali Ehresmann**, Isabella Hoffman**, Samuel Rupert**, Aidan Schmitt*

Pasco: Vanessa Ortiz**

Port Orchard: Joseph Kane*

Redmond: Cale Westman

Renton: Tyra Christopherson**, William Popp

Richland: Gracelyn Ward**

Ridgefield: Cameron Short**

Rochester: Joseph Morrissey*

Sammamish: Conor Leahy*

Seattle: Isabel Durrie-Vierling*, Geneva Feist**, Ruby Hale, Michael Heidal*, Alexandra Johnson**, Thomas Musselwhite*, Spencer Otis*, Christian Rogers, Nikolette Sabiers, Jessica Smith, Zain Wedemeyer**, Samuel Weston*, Lucia Williams

Selah: Olivia Boyle*, Kodie Duck*

Sequim: Tasheena Erickson

Shoreline: Logan Perrigo*

Snohomish: Octavian Culiac*, Jonah Gorder, Claire Turner

Spokane: Samantha Barker, Colton Fletcher, Thomas Halvorson, Lauren Potyk**

Sumas: Casey Bauman*

Tacoma: Sean Williams*

Tumwater: Cameron Huntley

Vancouver: Tristan Hoyer**

Waitsburg: Alexander Pickel

Walla Walla: Luke Anhorn*, Jackson Dominguez*, Jonathan Rasch

Wenatchee: Solomon Dormaier, Zachary Hurt**, Dawson Lewis Randall*, Grace Vejvoda*

Woodinville: Tristan Bomben, Tyler Bourgeois*, Daria Liborski, Eamon Ogrady*, Ridge Peterson, Matthew Thompson**

 

Wisconsin

Altoona: Emily Preston

Black Earth: John Becker

Eau Claire: Audrey Newby, Drake Schneider*

Fitchburg: Emily Moran

Hartland: Connor Flesch*

La Crosse: Caroline Gundersen**

Madison: Justin Gay

Menomonie: Jacob Fenton**

Minocqua: Taylor Preul-Stimetz

Port Washington: Samuel Fritsch*

Rothschild: Alexis Anderson

Sun Prairie: Lucille Rosenthal

 

Wyoming

Buffalo: Delaney Stine

Casper: Clayton Stirling

Cheyenne: Trace Ketterling**

Cody: Emma Heydenberk*

Gillette: Sage Kohr**

Jackson: Seren Web*

Otto: Zariah Tolman

Rawlins: Dylan Flack*

Rock Springs: Jill Blazovich, Mary Johnson

Sheridan: Bailey Coon**

Story: Colter Brown, Bradford Burns**

Thermopolis: Wyatt Wright*

Wilson: Alex Johnson**
